111111111111
1PCCCCCCCCC1
1C11C11C11C1
1CCCCCMCCCE1
111111111111
