11111111111111111
1PCCCC11CCCC11CC1
1ECCCC11CCCCCCCC1
1CCCCC11CCCC11CC1
1CCCCC11CMCC11CC1
1111CCCCC11111111
1111C111C11111111
1CCCCC11CCC11CCC1
1CCMCC11CCCMCCCC1
11111111111111111
