1111111111111111111
1P1CCCCC1CCC1CCCCC1
1C1C1C1C1C111C11111
1CCC1C1CCCCCCCCCCC1
11111C111111111C111
1CCC1CCC1CCCCCCC1C1
1C1C1C1C111C1C111C1
1C1CCC1C1CCC1CCCCC1
111111111C111111111
1CCC1CCC1CCC1C1C1C1
1C11111C1C111C1C1C1
1CCC1CCC1CCCCC1CCC1
111C111C1C1111111C1
1ECCCCCCCCCCCCCCCC1
1111111111111111111
