11111111
1E000001
11100111
MCCCCCCC
10000001
CCCCCCCM
11100111
MCCCCCCC
10000001
11100111
1P000001
11111111
