111111111111
1110C00C0111
111000000111
11ECCCCCCM11
11MCCCCCCC11
111000000111
111000000111
11MCCCCCCM11
111000000111
111000000111
11MCCCCCCM11
111000000111
111000000111
11CCCCCCCM11
111000000111
111000000111
11MCCCCCCC11
111000000111
111000000111
11CCCCCCCM11
111000000111
111000000111
11MCCCCCCC11
111000000111
111EC00C0111
111111111111