1111111111111
10000010000000C1
1000000111001
1P0011E0000001
1111111111111111
